2 13 5440 2012 4244 1224 3868 9626 9625 5422 3634 5419 2918 5080 2548 
3 19 3713 4867 3743 2520 4896 627 228 3236 3204 4938 2293 9613 3631 1491 5432 45 2276 2778 5418 
1 8 1224 5147 2844 9631 507 5222 250 5444 
2 28 5458 3430 1135 4242 5133 4053 3042 8129 409 5117 243 3531 2418 8360 690 3566 1811 5144 5166 239 3382 3831 5213 961 1973 853 3340 250 
2 25 5444 894 1024 3961 5306 286 5323 560 96 938 4026 5333 1947 885 4362 2973 2881 5319 3125 424 1758 1824 1026 3533 5238 
1 5 96 2838 3347 4166 2821 
2 18 5457 927 1335 1066 356 3476 3264 2578 3936 1614 126 2283 958 1577 5262 1384 2677 5444 
1 9 5457 4099 3997 246 1006 312 1227 5308 888 
1 23 2918 5096 1835 5445 1799 720 822 4381 3589 5119 5109 412 1528 473 9601 9602 4220 5206 768 5236 1775 284 5457 
2 3 170 4961 5408 
1 8 4820 3499 2672 571 4869 4883 3628 4818 
2 10 4883 3778 3498 263 3741 2593 979 4892 3418 4894 
1 10 4818 8558 9566 2851 4403 4406 75 3919 1291 2943 
2 7 170 4970 2068 4380 3475 441 4925 
2 6 2943 4958 2434 3331 1502 4380 
2 9 4403 648 1241 603 3084 155 1941 4990 8028 
1 2 8028 3386 
3 8 3386 3209 2494 5033 5027 700 580 5050 
5 5 5051 5043 7330 5030 3447 
5 5 5051 2704 3333 5061 5050 
5 6 2704 9587 5048 5042 4350 3447 
5 7 5051 3096 6863 5063 5055 3431 2116 
3 9 5050 9633 5017 3597 3225 3447 3369 2116 2546 
4 6 3655 4236 3353 5064 9641 2546 
4 7 5061 1624 2887 9632 9642 4127 3655 
2 8 1528 1371 3576 2874 5024 436 4979 2068 
1 2 1758 4382 
1 2 3825 1026 
1 4 8800 391 971 5238 
1 3 5271 2938 391 
1 4 5309 4106 3091 5238 
1 2 1717 5319 
1 2 1135 5556 
1 2 9576 8129 
1 2 228 4908 
2 2 284 3359 
1 13 3359 1072 84 2671 9621 1837 598 2733 15 2720 905 684 9599 
2 2 9598 9599 
2 10 9598 1165 763 3965 2888 3574 4309 1465 942 1624 
1 16 9601 3562 1545 3944 2177 2482 2169 5121 115 4302 2639 2787 3384 2157 2967 3209 
3 5 2913 1931 2357 3869 1941 
2 5 2913 4988 3841 4365 2943 
1 4 4302 1553 3803 2913 
2 10 2655 467 893 1876 4760 1386 4738 2144 4278 3301 
1 2 3301 2206 
1 2 4778 1876 
2 4 3301 4723 2126 1806 
1 5 2144 4727 309 4181 2201 
1 13 9594 975 69 1419 428 2182 1095 1119 2974 968 3444 543 1806 
2 9 2974 3797 1644 3106 2577 4717 128 3390 9594 
1 4 3106 72 3191 4766 
1 2 2924 4717 
2 5 4638 3573 3950 1762 2182 
1 8 3950 1219 2398 3874 4697 333 4183 2201 
2 7 69 3780 2697 3730 992 4594 3686 
1 3 992 2328 2240 
1 5 3950 4643 1273 4635 2240 
1 3 3577 3468 3686 
1 9 9595 4690 484 4651 491 350 9595 3581 9597 
2 3 9597 9596 9594 
2 8 3686 1850 2226 649 2372 1659 761 2709 
2 5 2709 2536 421 3561 4566 
1 7 1546 4534 1912 860 3170 1201 351 
1 3 761 3772 351 
2 4 1546 3864 2986 1159 
1 2 1961 1159 
3 6 4651 812 3725 347 1329 2856 
2 5 468 1963 4068 805 2856 
1 5 4068 697 1928 2818 78 
1 2 3595 78 
1 11 2818 2460 4660 3802 2680 4647 58 7303 7215 7702 7303 
1 13 7215 444 2642 7375 1766 4634 4253 2521 3343 153 6690 2670 66 
5 6 4497 9582 4502 9592 9593 9590 
5 2 4497 9590 
3 9 66 426 4646 2029 921 3206 499 3766 4624 
1 2 3206 4650 
4 9 4624 105 1169 1771 3865 4565 1096 2629 278 
3 6 3865 2078 2877 4575 969 278 
1 3 2877 3286 1096 
3 11 392 4513 2153 3404 4017 2558 3205 55 582 2523 278 
1 3 1096 3205 2558 
4 9 1190 392 4515 404 4525 3273 4520 9782 4224 
1 2 4224 4502 
5 4 4502 4508 9591 1190 
4 6 4497 4490 4473 1450 3846 2574 
1 5 9590 3037 107 1098 1199 
1 6 4490 182 4468 1668 3758 3579 
1 6 3865 4580 932 4560 2734 3261 
1 7 3474 401 3543 3479 1278 3726 4647 
1 3 812 2641 3772 
1 10 2856 2878 1709 4578 3299 4557 4055 1679 4516 1159 
1 4 351 3486 3358 2878 
3 19 1159 4509 689 1157 4469 4453 1897 2263 4415 259 3346 2681 3445 974 3175 959 2338 667 4510 
2 9 4510 2965 3786 1649 4489 3410 172 1436 4113 
1 6 4113 4461 3884 2942 2028 2895 
1 3 3884 4440 2215 
1 3 959 4464 765 
3 14 689 3427 2746 363 2674 4521 157 3527 3515 4133 2321 4501 92 2168 
4 4 2321 1728 4204 1662 
5 15 4520 9782 9778 2127 4514 1297 545 2993 107 4473 182 4482 4486 9779 392 
3 4 2168 4272 3242 384 
1 2 4410 4514 
3 3 4443 437 2907 
1 3 4443 307 3513 
1 9 3513 3530 2250 3823 1596 2058 4477 2427 1297 
3 2 3070 7375 
1 2 820 3225 
4 12 820 2148 3403 486 4935 242 1246 1816 3249 4866 2598 3424 
3 11 1113 9134 2827 553 4803 1021 2928 4038 2649 3791 3424 
3 6 1113 568 1017 4731 3887 3942 
3 7 3887 1809 422 1418 225 4664 4669 
1 2 4669 4664 
1 5 225 2000 4641 4355 4604 
1 6 4604 1028 1288 9603 1986 4600 
3 17 2514 4700 1994 427 4737 264 2658 1764 4773 2163 1332 645 3188 2609 8290 3791 2649 
1 2 264 807 
3 18 3094 375 2653 793 385 2053 3774 2894 1161 2544 2853 3770 605 9611 3605 987 3845 3791 
4 8 7756 1651 6192 252 1920 2922 8630 8103 
3 3 4120 4549 7756 
2 25 7756 1651 1903 4543 2786 367 2052 3056 419 4308 192 4529 1363 4402 4346 4539 4541 9650 691 3086 2220 2721 4597 200 4600 
3 14 8103 429 3565 4405 1421 112 4131 120 205 4076 1156 2017 4687 2514 
1 8 8103 86 1655 3583 4589 152 3668 8857 
1 7 8857 388 2604 746 3260 2885 2467 
2 4 2467 767 344 9650 
1 10 4076 3151 3500 9648 3207 895 1380 2399 691 9650 
1 8 895 1407 213 857 3015 1218 388 8857 
1 8 9648 2775 4605 2200 3015 1218 388 8857 
3 9 8103 3769 771 4252 4691 4048 48 4716 9689 
3 13 8103 8630 4194 3582 1556 4267 1611 4648 1036 602 985 2539 9693 
1 2 2474 1036 
1 11 2474 555 2682 1989 173 1468 1206 1619 302 3354 7756 
1 6 2474 3460 1514 4639 2282 2539 
2 8 9693 741 4698 3532 1525 4102 1734 9689 
1 3 9689 9690 1822 
1 3 9691 9692 9693 
1 3 2258 9696 4639 
1 3 3819 9697 4639 
3 10 3556 290 2506 3888 2056 495 143 980 2969 77 
2 5 77 2375 3625 1003 7934 
2 3 77 833 3710 
1 4 4120 116 4532 980 
2 14 116 4269 4558 3912 1012 7926 3181 29 2344 511 870 154 3819 1613 
3 7 3556 1622 447 692 1331 3804 154 
1 6 7926 2102 4564 1202 1427 3330 
1 12 833 4480 8180 2568 4018 2864 1011 8342 8828 339 1361 290 
1 5 3556 3267 4475 305 8869 
1 16 8869 3662 74 4435 3248 1447 4445 2208 3317 203 4058 1757 1403 2065 4231 1331 
1 3 4533 9699 1757 
1 3 4066 5681 3317 
1 3 2134 8861 2208 
1 3 925 9698 1613 
3 9 3273 3608 1086 2873 1041 4601 3862 8794 6690 
1 6 3608 1051 1464 1686 3960 3261 
1 9 4520 1810 1432 1761 2404 3417 301 674 1766 
1 21 2856 3488 3193 354 358 179 1767 1603 855 4591 1874 4042 4583 664 150 1969 4545 2553 3696 3143 1810 
1 13 1679 518 2684 2867 94 1133 4175 463 4047 4535 1537 2271 4272 
2 3 9599 4274 2720 
3 2 5439 1786 
1 3 1786 9600 2260 
2 6 2260 931 2770 389 5381 1401 
1 8 9598 5208 3277 2549 3287 3081 1264 5439 
1 5 4533 2552 341 2927 925 
1 7 925 2247 1001 2535 2142 4640 2258 
1 13 5439 3987 1576 1705 5342 1925 1115 3681 3082 3278 4193 937 1981 
5 6 9656 9652 9655 9658 9657 3779 
5 5 9655 9651 9654 9733 9653 
5 5 2365 9735 9660 9659 9653 
3 8 9660 2367 1952 281 2046 159 4344 9743 
1 3 9743 9746 3541 
2 4 9744 9742 3980 2046 
3 3 3541 1198 9744 
3 12 9744 1780 4432 4290 3380 4425 3130 1959 4143 2836 3146 1684 
2 3 3380 9745 4290 
1 2 9741 9743 
4 3 9654 1237 2607 
4 3 9653 631 4537 
3 3 2046 1753 4066 
3 3 4344 2193 2134 
1 2 2134 4066 
1 2 445 1753 
3 5 4537 501 2074 1085 4533 
4 3 2607 9731 2309 
1 2 4444 3146 
1 3 4493 4505 9657 
1 2 219 3779 
5 5 3779 1290 4495 4504 4057 
3 6 4495 1812 2932 2611 2264 4444 
3 22 2607 4286 4574 3054 4593 3275 3607 719 2351 4663 345 574 4710 3648 1504 3312 3238 3208 4790 1120 1729 2374 
2 33 2374 1782 1097 753 462 4856 2880 4880 1523 1584 900 846 3052 4966 3295 500 4149 100 216 2320 9586 830 4103 2294 343 2707 456 1007 2527 734 191 1834 5338 
3 3 2309 2685 4537 
2 3 3275 9726 4619 
3 3 4619 2137 9728 
1 3 3054 267 9661 
1 3 1290 433 2835 
1 3 2835 1667 3544 
1 5 4504 2476 4271 3927 254 
4 8 341 4587 60 4586 2456 643 3709 2685 
2 6 2137 4599 414 3528 4568 643 
1 3 3564 9671 2339 
2 3 9669 9670 9667 
1 3 5108 9665 9664 
3 10 4127 2834 5108 5143 1828 9669 794 3521 5186 2798 
2 13 2798 5167 1405 9752 3934 2934 1608 3812 4321 1245 1976 926 9749 
1 3 9749 9751 9750 
2 4 3934 5202 5220 3564 
3 19 4236 997 4356 3976 521 2317 2212 1185 755 4061 2335 5118 776 5139 271 3322 1793 3906 9750 
1 2 1405 3578 
4 4 9632 4200 2452 9664 
3 3 9664 1640 9667 
1 8 9667 3332 1499 879 624 3149 4023 2339 
1 2 1459 1499 
1 7 3564 1670 1020 1602 2414 926 9749 
2 11 1786 563 413 158 652 2129 3107 2624 5233 4360 2339 
3 16 4820 2171 17 4154 1820 4334 1446 632 1604 2195 4933 2196 1354 1409 3018 820 
1 16 2546 1426 2654 1909 4995 59 4973 1930 478 3008 4939 1905 4941 1571 375 3094 
1 3 1276 9673 599 
2 8 1602 811 661 3767 97 395 2036 1755 
1 5 1755 3983 1176 3304 1276 
1 4 1755 3784 1149 3220 
1 3 3578 1700 4061 
1 4 807 4276 1353 438 
2 3 427 1034 4187 
1 4 1375 2097 1213 4187 
1 2 1517 427 
1 5 1375 383 2131 3226 4654 
1 8 4654 9 1293 1250 4809 2950 7 4819 
1 3 4819 9685 2750 
2 5 2750 1360 882 4374 9680 
1 3 9680 9681 3523 
1 4 9680 4374 2723 1016 
3 7 1016 5429 2807 4085 2400 1460 4948 
2 10 4948 3580 1904 3971 1127 547 2047 5090 1634 3079 
3 8 1822 2360 9584 4248 2979 516 9583 2750 
1 3 1945 9668 4948 
1 3 5095 9756 9755 
3 10 4948 3048 3921 687 3716 4983 4972 722 9758 3739 
2 2 3739 416 
1 3 722 1539 4919 
1 3 3079 3135 5095 
3 14 9755 1695 3585 2625 2141 1356 2301 3113 3298 5152 63 32 1580 5112 
3 7 416 4228 253 3060 3826 3090 1356 
2 12 5112 3195 2049 3000 5210 2937 4234 2495 2695 2429 5317 4044 
2 17 4044 685 832 9636 223 2930 579 2773 361 5334 3814 5327 4215 3507 5364 2308 2377 
2 11 2625 2618 2146 621 5228 3538 2284 247 5312 2749 5334 
1 28 4234 1992 651 1283 941 2120 3538 5253 5246 908 4115 2868 2185 3861 415 752 3641 2281 2229 2947 1561 728 5243 386 111 749 4176 3906 
1 12 3094 2714 2910 1594 2336 1320 2299 3097 4388 4240 1773 1945 
2 17 271 5140 947 2977 1068 5128 4121 2401 1564 2872 5086 3665 3893 3806 3853 3443 5095 
1 17 3607 4620 1307 4610 4612 849 3339 1849 702 2423 866 869 65 2262 2296 3128 4335 
3 9 2374 9713 3973 2041 3314 3982 3711 3844 2392 
1 8 254 4538 3593 3720 1390 1759 2322 866 
3 13 869 1970 1933 617 2509 1547 4715 1044 2080 2631 3078 898 3844 
1 5 3544 3437 490 1368 4612 
1 5 1504 9715 9714 9717 9716 
2 15 9716 4287 9718 3903 114 9721 9722 2189 2656 1581 4153 2491 4637 9725 4619 
1 18 4919 3788 3440 2462 3034 3833 4850 1184 2805 2688 466 2923 300 1262 1591 2801 952 4287 
1 3 1892 9705 1570 
1 4 1892 9706 9707 1184 
2 5 4983 513 730 5072 5095 
1 21 1822 2788 1182 238 4718 3996 775 1569 1399 4137 1413 3441 2935 3762 1451 4713 1280 4361 3296 522 114 
1 16 1892 4881 3748 1258 2998 257 1841 3180 2919 3776 525 2223 1300 2246 1580 5112 
1 29 5112 2586 2893 3933 5035 2315 2980 1737 1188 4932 1501 337 2632 1694 3320 1324 2214 2451 3413 3723 3706 3280 865 3899 4184 2471 4757 2356 9714 
1 6 5364 134 2314 3928 1842 1337 
1 5 2947 57 5287 2601 1337 
1 4 1337 792 519 2261 
1 2 3375 5333 
1 4 8360 5106 1330 5104 
1 4 1393 2386 5059 5065 
1 2 1393 5117 
1 7 5064 335 3596 5018 310 5016 160 
1 3 9728 9729 3275 
1 2 2246 4390 
1 3 574 9723 9722 
1 9 1001 145 642 2348 2076 4277 3670 1352 2491 
1 3 9691 9694 4640 
1 4 9691 1697 1955 1399 
1 15 3833 1005 4834 4319 4802 3683 4771 2719 3259 3510 4190 3749 4728 2788 1822 
1 2 2125 3314 
1 3 1782 9712 3413 
1 3 3320 9704 2880 
1 3 9700 9701 1543 
1 2 337 1543 
1 2 1948 2527 
1 2 5283 1948 
1 4 4269 8111 9677 302 
1 3 4558 9675 1619 
1 3 3181 9674 1989 
4 40 457 3697 2432 3790 2162 5385 5388 4148 1151 3274 2675 3220 5401 2306 1540 2855 4336 2575 3816 2261 2794 2590 5377 1249 4312 34 2377 5391 2110 5396 2550 3293 5404 1230 3717 5395 609 3673 5365 2930 
1 3 5418 9609 5408 
